#######################
#G=.*//==//*//==//*.*.#
#...=//////#//////=.#.#
#.=.#=====#*#=====#.=S#
#.=.*..#..///..#..*.==#
#*#.#.....#.#.....#.*S#
#B*.#//#..#.#..#//#.#=#
#*#.#.....#.#.....#.*S#
#.=.*..#..///..#..*.==#
#.=.#=====#*#=====#.=S#
#...=//////#//////=.#.#
#Y=.*//==//*//==//*.*.#
#######################

RELOAD = 55
VELOCITY = 4
CD_FOR_SPAWN = 1000
MAX_ENEMY_TANKS = 20
GREEN_TANK_VECTOR = 2
YELLOW_TANK_VECTOR = 0
MAX_ENEMY_TANKS_ON_SCREEN = 8