#######################
#1=.*//==//*//==//*.*.#
#...=//////#//////=.#.#
#.=.#=====#*#=====#.=S#
#.=.*..#..///..#..*.==#
#*#.#.....#.#.....#.*S#
#B*.#//#..#.#..#//#.#=#
#*#.#.....#.#.....#.*S#
#.=.*..#..///..#..*.==#
#.=.#=====#*#=====#.=S#
#...=//////#//////=.#.#
#2=.*//==//*//==//*.*.#
#######################

RED_TANK_VECTOR = 2
BLUE_TANK_VECTOR = 0
RELOAD = 55
VELOCITY = 4
CD_FOR_SPAWN = 1000
MAX_ENEMY_TANKS = 20
MAX_ENEMY_TANKS_ON_SCREEN = 8